NO         ./textures/W28_6.png
SO     ./textures/W96_2.png
WE ./textures/WALL69_4.png
EA ./textures/RP1_1.png

F 95, 95, 95

C 35, 35, 35, 255

                                                            111111111111111111111111111111111111
                                                            100000000000000000000000000000000001
                                                            100000000000000000000000000000000001
                                                            100000000000000000111111111000000001
                                                            100000000000000000000000001000000001
                                                            100000000000000000000000001000000001
                                                            100000000000000000000000001000000001
                                                            100000000000000000000000001000000001
                                                   111111111100000000000000000000000001000000001
                                                  100000000D000000000000000000000000001000000001
                                                 100011111111000000000000000000000000010000000011111111
                                                10001       100000000000000000000000001000000000000000011
                                               10001        10000000000000000111111111100000000111111000011
                                              10001        100000000000000000000000000000000001     11000011111111
                                  P{||}{P|{}|P00001        111111111111111111111111111111111111       110000000001
      1111111        11111111111  1000000000000000:                                                     1100000001
     100000001       10000000001  1000000000000000:                                                       11111111
    10000000001      10000P00001 11000000000000000L
   1000000000001     10000000001 10000T000000T0000K
  100000000000001111110000000001110000000000000000L  
  100000000000000000000000000000000000000000000000O
  100000000000001111110000000001110000T000000T0000K
   1000000000001     10000000001 10000000000000000:
    10000000001      10000{00001 11000000000000000O
     100000001       10000000001  1000000N00000000:
      1111111        11111111111  1000000000000000L
                                  11111110111111111
                                        1D1
										111