NO         ./textures/FLAT5_6.png
SO     ./textures/WLL.png
WE ./textures/HELL5_1.png
EA ./textures/LAVA3.png

F 0,255,124,241

C 132,145,75,0

C 30  ,  00,10
F 80,60,30

        1111111111111111111111111
        100D000000000000000000001
        1011000000000000000000001
        1011000000000000000000001
        1011000000000000000000001
        101100000000S000000000001
        1011000000000000000000001
        1011000000000000000000001
        1001000000000000000000001
111111111011000001110000000000001
10000000001100000111D111111111111
111101111111110111000D001
11111111111111011101010011111
11000000110101011100000010001
10000000000000001100000010001
10000000000000001101010010001
110000011101010111110111100111
11110111 1110101 101111010001
11111111 1111111 111111111111
