NO ./textures/S1.png
SO ./textures/S2.png
WE ./textures/S3.png
EA ./textures/S4.png
F 220,100,0
C 225,f,0
111111
100101
101001
1100N1
111111
