NO ./textures/S1.png
SO ./textures/S2.png
WE ./textures/S3.png
EA ./textures/S4.png
F 65,103,64
C 2,11,83
111111111111
10001000000N
100000000001
111111111111