  
NO ./textures/S1.png 
SO ./textures/S2.png   

    
WE ./textures/S3.png    
EA ./textures/S4.png  
  
F 65,103,64
       
C    2,11,83     
    
11111111
100101 1
10100111
1100N1 1
11111111


   
    
