NO ./textures/S1.png
SO ./textures/S2.png
WE ./textures/S3.png
EA ./textures/S4.png

F 95, 95, 95

C 35, 35, 35, 255

1111111111111111111111111111111
1011111111110011101111111111111
1000000000110000001000000000001
1011000001110000001000000000001
1001000000010000001000000000001
1111111110110000001000011100001
1000000000000000000000011101111
111100N000110000001101110000001
1111000000110000001101110101001
1100000011010000001101110000001
1000000000010000001000110000001
1000000000010000001000110101001
1111111111111111111111111111111
